save = Guardar
search = Buscar
date = Fecha
time = Hora
team = Equipo|Equipos
extension = Extensión|Extensiones
flag = Bandera|Banderas
number = Número
duration = Duración
actions = Acciones
general = General
description = Descripción
synchronize = Sincronizar
cancel = Cancelar
all = Todos
none = Ninguno
select = -- Seleccionar --
note = Nota|Notas
call_type = Tipo de Llamada
reference = Referencia
rating = Calificación
internal = Interna
incoming = Entrante
outgoing = Saliente
search_by = Búsqueda por
delete = Eliminar
delete.confirmation = ¿Está seguro de que desea eliminar este item?
delete.success = El item se ha eliminado correctamente
update.success = Los datos se han actualizado en la base de datos.
save.success = Los datos se han agregado a la base de datos.
new = Nuevo
send = Enviar
close = Cerrar
error = Error
download = Descargar
name = Nombre
user = Usuario|Usuarios
password = Contraseña
january = Enero
february = Febrero
march = Marzo
april = Abril
may = Mayo
june = Junio
july = Julio
august = Agosto
september = Septiembre
october = Octubre
november = Noviembre
december = Diciembre
monday = Lunes
tuesday = Martes
wednesday = Miércoles
thursday = Jueves
friday = Viernes
saturday = Sábado
sunday = Domingo
username = Usuario
username.validation = Por favor, ingrese su Usuario
password.validation = Por favor, introduzca su contraseña
login = Iniciar Sesión
wizard.title = Clave de Administrador
password.retype = Vuelva a Escribir la Contraseña
password.retype.validation.required = Por favor, escriba de nuevo su contraseña
password.retype.validation.equalTo = Por favor, introduzca el mismo valor de nuevo
accept = Aceptar
no_data_avail = Datos no Disponibles
sign_in = Registrarse
language = Idioma
logout = Cerrar Sesión
no_info = Sin Información
update = Actualizar
yes = Si
no = No
add = Añadir
change = Cambiar
remove = Eliminar
select_image = Seleccionar Imagen
warning_msg = %s Advertencia
number.abbr = No.
option = Opción|Opciones