save = Uložit
search = Hledat
date = Datum
time = Čas
team = Tým|Týmy
extension = Pobočka|Pobočky
flag = Vlajka|Vlajky
number = Číslo
duration = Doba trvání
actions = Akce
general = Obecné
description = Popis
synchronize = Synchronizovat
cancel = Zrušit
all = Vše
none = Žádný
select = -- Vyberte --
note = Poznámka|Poznámky
call_type = Typ hovoru
reference = Reference
rating = Hodnocení
internal = Interní
incoming = Příchozí
outgoing = Odchozí
search_by = Hledat podle
delete = Smazat
delete.confirmation = Jste si jisti, že chcete tuto položku smazat?
delete.success = Položka byla úspěšně odstraněna
update.success = Data byla aktualizována v databázi
save.success = Data byla přidána do databáze
new = Nový
send = Odeslat
close = Zavřít
error = Chyba
download = Stáhnout
name = Jméno
user = Uživatel|Uživatelé
password = Heslo
january = Leden
february = Únor
march = Březen
april = Duben
may = Květen
june = Červen
july = Červenec
august = Srpen
september = Září
october = Říjen
november = Listopad
december = Prosinec
monday = Pondělí
tuesday = Úterý
wednesday = Středa
thursday = Čtvrtek
friday = Pátek
saturday = Sobota
sunday = Neděle
username = Uživatelské jméno
username.validation = Prosím, zadejte své uživatelské jméno
password.validation = Prosím, zadejte své heslo
login = Přihlášení
wizard.title = Heslo Administrátora
password.retype = Znovu zadejte heslo
password.retype.validation.required = Prosím, zadejte znovu své heslo
password.retype.validation.equalTo = Prosím, zadejte stejnou hodnotu znovu
accept = Přijmout
no_data_avail = Žádná data nejsou k dispozici
sign_in = Přihlásit se
language = Jazyk
logout = Odhlásit se
no_info = Žádné informace
update = Aktualizovat
yes = Ano
no = Ne
add = Přidat
change = Změnit
remove = Odebrat
select_image = Vybrat obrázek
warning_msg = %s Upozornění
number.abbr = Č.
option = Možnost|Možnosti