save = Salvar
search = Pesquisar
date = Data
time = Tempo
team = Equipe|Equipes
extension = Extensão|Extensões
flag = Bandeira|Bandeiras
number= Número
duration = Duração
actions = Ações
general = Geral
description = Descrição
synchronize = Sincronizar
cancel = Cancelar
all = Todos
none = Nenhum
select = -- Selecione --
note = Nota|Notas
call_type = Tipo de chamada
reference = Referência
rating = Classificação
internal = Interno
incoming = Entrada
outgoing = Saída
search_by = Pesquisar por
delete = deletar
delete.confirmation = Tem certeza que deseja excluir este item?
delete.success = O item foi removido com sucesso
update.success = Os dados foram atualizados no banco de dados
save.success = Os dados foram adicionados ao banco de dados
new = Novo
send = Enviar
close = Fechar
error = Erro
download = Baixar
name = Nome
user = Usuário|Usuários
password = Senha
january = Janeiro
february = Fevereiro
march = Março
april = Abril
may = Maio
june = Junho
july = Julho
august = Agosto
september = Setembro
october = Outubro
november = Novembro
december = Dezembro
monday = Segunda-feira
tuesday = Terça-feira
wednesday = Quarta-feira
thursday = Quinta-feira
friday = Sexta-feira
saturday = Sábado
sunday = Domingo
username = Nome de usuário
username.validation = Por favor, digite seu nome de usuário
password.validation = Por favor, digite sua senha
login = Entrar
wizard.title = Senha do administrador
password.retype = Digite novamente a senha
password.retype.validation.required = Por favor, redigite sua senha
password.retype.validation.equalTo = Insira o mesmo valor novamente
accept = aceitar
no_data_avail = Nenhum dado disponível
sign_in = Entrar
language = Idioma
logout = Sair
no_info = Sem informações
update = Atualizar
yes= Sim
no = Não
add = Adicionar
change = mudar
remove = remover
select_image = Selecionar imagem
warning_msg = %s Aviso
número.abbr = Não.
opção = Opção|Opções